074 074 074 019 019 019 019 019 019 019 019 019 019 019 019 019 019 019 019 019 019 019 019 019 019 019 019 019 024 019
065 065 065 019 019 019 019 019 019 019 019 019 019 019 019 019 019 019 019 019 019 019 019 019 019 019 019 019 024 019
065 065 065 019 019 037 037 037 037 037 037 037 037 037 037 037 037 037 037 037 037 037 037 037 037 037 037 019 024 019
065 065 065 019 005 024 024 024 024 024 024 024 024 024 024 024 024 024 024 024 024 024 024 024 024 024 024 024 043 019
065 065 065 019 024 019 019 019 019 019 019 019 019 019 019 019 019 019 019 019 019 019 019 019 019 019 019 019 019 019
065 065 065 019 024 019 037 037 037 037 037 037 037 037 037 037 037 037 037 037 037 037 037 037 037 037 037 037 019 019
065 065 065 019 041 024 024 024 024 024 024 024 024 024 024 024 024 024 024 024 024 024 024 024 024 024 024 024 024 007
065 065 065 019 019 019 019 019 019 019 019 019 019 019 019 019 019 019 019 019 019 019 019 019 019 019 019 019 019 024
065 065 065 019 019 037 037 037 037 037 037 037 037 037 037 037 037 037 037 037 037 037 037 037 037 037 037 037 019 024
065 065 065 005 024 024 024 024 024 024 024 024 024 024 024 024 024 024 024 024 024 024 024 024 024 024 024 024 024 043
065 065 065 024 019 019 019 019 019 019 019 019 019 019 019 019 019 019 019 019 019 019 019 019 019 019 019 019 019 019
065 065 065 024 019 037 037 037 037 037 037 037 037 037 037 037 037 037 037 037 037 037 037 037 037 037 037 037 019 019
065 065 065 041 024 024 024 024 024 024 024 024 024 024 024 024 024 024 024 024 024 024 024 024 024 024 024 024 007 019
065 065 065 019 019 019 019 019 019 019 019 019 019 019 019 019 019 019 019 019 019 019 019 019 019 019 019 041 024 019
065 065 065 019 019 019 019 019 019 019 019 019 019 019 019 019 019 019 019 019 019 019 019 019 019 019 019 019 024 019
065 065 065 019 019 019 019 019 019 019 019 019 019 019 019 019 019 019 019 019 019 019 019 019 019 019 019 019 024 019
065 065 065 019 019 019 019 019 019 019 019 019 019 019 019 019 019 019 019 019 019 019 019 019 019 019 019 019 024 019
065 065 065 065 065 065 065 065 065 065 065 065 065 065 065 065 065 065 065 065 065 065 065 065 065 065 065 142 142 142
065 065 065 065 065 065 065 065 065 065 065 065 065 065 065 065 065 065 065 065 065 065 065 065 065 065 065 142 142 142
065 065 065 065 065 065 065 065 065 065 065 065 065 065 065 065 065 065 065 065 065 065 065 065 065 065 065 142 142 142
9
896 96
128 96
128 192
928 192
928 288
96 288
96 384
896 384
896 468
6
896 0
Spawner
Target 864 468
SmallerEnemy DOWN 4
NormalEnemy DOWN 3
TankerEnemy DOWN 2
BossEnemy DOWN 1