074 074 074 019 019 019 019 019 019 019 019 019 019 019 019 019 019 019 019 019 019 019 019 019 019 019 019 133 133 133
065 065 065 019 019 019 019 019 019 019 019 019 019 019 019 019 019 019 019 019 019 019 019 019 019 019 019 133 019 019
065 065 065 024 024 024 024 019 019 019 019 019 019 019 019 019 019 024 024 024 024 024 024 024 024 024 024 024 019 019
065 065 065 019 019 019 024 019 019 019 019 019 019 019 019 019 019 024 019 019 019 019 019 019 019 019 019 133 019 019
065 065 065 019 019 019 024 019 019 019 019 019 019 019 019 019 019 024 019 019 019 019 019 019 019 019 019 133 133 133
065 065 065 019 019 019 024 019 019 019 019 019 019 019 019 019 019 024 019 019 019 019 019 019 019 019 019 019 019 019
065 065 065 019 019 019 024 019 019 019 019 019 019 019 019 019 019 024 019 019 019 019 019 019 019 019 019 019 019 019
065 065 065 019 019 019 024 019 019 019 019 019 019 019 019 019 019 024 019 019 019 019 019 019 019 019 019 019 019 019
065 065 065 019 019 019 024 019 019 019 019 019 019 019 019 019 019 024 019 019 019 019 019 019 019 019 019 019 019 019
065 065 065 019 019 019 024 019 019 019 019 019 019 019 019 019 019 024 024 024 024 024 024 024 024 024 024 019 019 019
065 065 065 019 019 019 024 019 019 019 019 019 019 019 019 019 019 019 019 019 019 019 019 019 019 019 024 019 019 019
065 065 065 019 019 019 024 019 019 019 019 019 019 019 019 019 019 019 019 019 019 019 019 019 019 019 024 019 019 019
065 065 065 019 019 019 024 019 019 019 019 019 019 019 019 019 019 019 019 019 019 019 019 019 019 019 024 019 019 019
065 065 065 019 019 019 024 019 019 019 019 019 019 019 019 019 019 019 019 019 019 019 019 019 019 019 024 019 019 019
065 065 065 019 019 019 024 024 024 024 024 024 024 024 024 024 024 024 024 024 024 024 024 024 024 024 024 019 019 019
065 065 065 019 019 019 019 019 019 019 019 019 019 019 019 019 019 019 019 019 019 019 019 019 019 019 019 019 019 019
065 065 065 019 019 019 019 019 019 019 019 019 019 019 019 019 019 019 019 019 019 019 019 019 019 019 019 019 019 019
065 065 065 065 065 065 065 065 065 065 065 065 065 065 065 065 065 065 065 065 065 065 065 065 065 065 065 142 142 142
065 065 065 065 065 065 065 065 065 065 065 065 065 065 065 065 065 065 065 065 065 065 065 065 065 065 065 142 142 142
065 065 065 065 065 065 065 065 065 065 065 065 065 065 065 065 065 065 065 065 065 065 065 065 065 065 065 142 142 142
7
192 64
192 448
832 448
832 288
544 288
544 64
864 64

112 64
864 32
5
1 SmallerEnemy RIGHT 15
1 NormalEnemy RIGHT 10
1 TankerEnemy RIGHT 8
3 SmallerEnemy RIGHT 10 NormalEnemy RIGHT 8 TankerEnemy RIGHT 5
1 BossEnemy RIGHT 1