074 074 074 019 019 019 019 019 019 019 019 019 019 019 019 019 019 019 019 019 019 019 019 024 133 019 019 019 019 019
065 065 065 019 024 024 024 024 019 019 019 019 019 019 019 019 019 019 019 019 019 019 019 024 133 019 019 019 019 019
065 065 065 019 024 019 019 024 024 024 024 024 024 024 024 024 024 024 024 024 024 024 024 024 133 019 019 019 019 019
065 065 065 019 024 019 019 019 019 019 019 019 019 019 019 019 019 019 019 019 019 019 019 019 133 133 133 024 133 133
065 065 065 019 024 019 019 019 019 019 019 019 019 019 019 019 019 019 019 019 019 019 019 019 019 019 019 024 019 019
065 065 065 019 024 019 019 024 024 024 024 024 024 024 024 019 019 024 024 024 024 024 024 024 024 024 024 024 019 019
065 065 065 019 024 019 019 024 019 019 019 019 019 019 024 019 019 024 019 019 019 019 019 019 019 019 019 019 019 019
065 065 065 019 024 024 024 024 019 019 019 019 019 019 024 019 019 024 019 019 019 019 019 019 019 019 019 019 019 019
065 065 065 019 019 019 019 019 019 019 019 019 019 019 024 019 019 024 019 019 019 019 019 019 019 019 019 019 019 019
065 065 065 019 019 019 019 019 019 019 019 019 019 019 024 019 019 024 019 019 019 019 019 019 019 019 019 019 019 019
065 065 065 019 019 019 019 019 019 019 019 019 019 019 024 019 019 024 019 019 019 019 019 019 019 019 019 019 019 019
065 065 065 019 019 019 019 019 024 024 024 024 024 024 024 019 019 024 024 024 024 024 024 024 024 024 024 024 024 019
065 065 065 019 019 019 019 019 024 019 019 019 019 019 019 019 019 019 019 019 019 019 019 019 019 019 019 019 024 019
065 065 065 019 019 019 019 019 024 019 019 019 019 019 019 019 019 019 019 019 019 019 019 019 019 019 019 019 024 019
065 065 065 019 019 019 019 019 024 019 019 019 019 019 019 019 019 019 019 019 019 019 019 019 019 019 019 019 024 019
065 065 065 019 019 019 019 019 024 024 024 024 024 024 024 024 024 024 024 024 024 024 024 024 024 024 024 024 024 019
065 065 065 019 019 019 019 019 019 019 019 019 019 019 019 019 019 019 019 019 019 019 019 019 019 019 019 019 019 019
065 065 065 065 065 065 065 065 065 065 065 065 065 065 065 065 065 065 065 065 065 065 065 065 065 065 065 142 142 142
065 065 065 065 065 065 065 065 065 065 065 065 065 065 065 065 065 065 065 065 065 065 065 065 065 065 065 142 142 142
065 065 065 065 065 065 065 065 065 065 065 065 065 065 065 065 065 065 065 065 065 065 065 065 065 065 065 142 142 142
17
736 64
224 64
224 32
128 32
128 224
224 224
224 160
448 160
448 352
256 352
256 480
896 480
896 352
544 352
544 160
864 160
864 64

736 32
864 64
5
1 SmallerEnemy DOWN 10
1 NormalEnemy DOWN 8
1 TankerEnemy DOWN 5
3 SmallerEnemy DOWN 1 NormalEnemy DOWN 1 TankerEnemy DOWN 1
1 BossEnemy DOWN 1