074 074 074 019 019 019 019 019 019 019 019 019 019 019 019 019 019 019 019 019 019 019 019 019 019 019 019 019 019 019
065 065 065 019 024 024 024 024 024 024 024 024 024 024 024 024 024 024 024 024 024 024 024 024 024 024 024 024 024 019
065 065 065 019 024 019 019 019 019 019 019 019 019 019 019 019 019 019 019 019 019 019 019 019 019 019 019 019 024 019
065 065 065 019 024 019 019 019 019 019 019 019 019 019 019 019 019 019 019 019 019 019 019 019 019 019 019 019 024 019
065 065 065 019 024 019 019 024 024 024 024 024 024 024 024 024 024 024 024 024 024 024 024 024 024 024 019 019 024 019
065 065 065 019 024 019 019 024 019 019 019 019 019 019 019 019 019 019 019 019 019 019 019 019 019 024 019 019 024 019
065 065 065 019 024 019 019 024 019 019 019 019 019 019 019 019 019 019 019 019 019 019 019 019 019 024 019 019 024 019
065 065 065 019 024 019 019 024 019 019 024 024 024 024 024 024 024 024 024 024 024 024 024 019 019 024 019 019 024 019
065 065 065 019 024 019 019 024 019 019 024 019 133 133 133 133 133 133 133 019 019 019 024 019 019 024 019 019 024 019
065 065 065 019 024 019 019 024 019 019 024 019 133 019 019 019 019 019 133 019 019 019 024 019 019 024 019 019 024 019
065 065 065 019 024 019 019 024 019 019 024 019 133 019 019 019 019 019 024 024 024 024 024 019 019 024 019 019 024 019
065 065 065 019 024 019 019 024 019 019 024 019 133 133 133 133 133 133 133 019 019 019 019 019 019 024 019 019 024 019
065 065 065 019 024 019 019 024 019 019 024 024 024 024 024 024 024 024 024 024 024 024 024 024 024 024 019 019 024 019
065 065 065 019 024 019 019 024 019 019 019 019 019 019 019 019 019 019 019 019 019 019 019 019 019 019 019 019 024 019
065 065 065 019 024 019 019 024 019 019 019 019 019 019 019 019 019 019 019 019 019 019 019 019 019 019 019 019 024 019
065 065 065 019 024 019 019 024 024 024 024 024 024 024 024 024 024 024 024 024 024 024 024 024 024 024 024 024 024 019
065 065 065 019 024 019 019 019 019 019 019 019 019 019 019 019 019 019 019 019 019 019 019 019 019 019 019 019 019 019
065 065 065 065 065 065 065 065 065 065 065 065 065 065 065 065 065 065 065 065 065 065 065 065 065 065 065 142 142 142
065 065 065 065 065 065 065 065 065 065 065 065 065 065 065 065 065 065 065 065 065 065 065 065 065 065 065 142 142 142
065 065 065 065 065 065 065 065 065 065 065 065 065 065 065 065 065 065 065 065 065 065 065 065 065 065 065 142 142 142
12
128 32
896 32
896 480
224 480
224 128
800 128
800 384
320 384
320 224
704 224
704 320
576 320

128 512
576 320
5
1 SmallerEnemy UP 10
1 NormalEnemy UP 8
1 TankerEnemy UP 5
3 SmallerEnemy UP 1 NormalEnemy UP 1 TankerEnemy UP 1
1 BossEnemy UP 1